R 800 640
NO ./textures/book_shelf_nourth.xpm
SO ./textures/book_shelf_south.xpm
WE ./textures/book_shelf_west.xpm
EA ./textures/book_shelf_east.xpm
S ./textures/wizard.xpm
F 0,38,77
C 21,21,21
            1111111111111111111111111
            1000000000110000000000001
            1011000001110000002000001
            10010000000000000000W0001
    111111111011000001110000000000001
    100000000011000001110111111111111
    11110111111111011100000010001
    11110111111111011101010010001
    11000000110101011100000010001
    10002000000000001100000010001
    10000000000000001101010010001
    1100000111010101111101111022111
    11110111 1110101 101111010001
    11111111 1111111 111111111111