R 400 400
NO ./textures/grass.xpm
SO ./textures/grass.xpm
WE ./textures/grass.xpm
EA ./textures/grass.xpm
S ./textures/sword.xpm
F 95,150,90
C 190,190,255
            111111111111111111111
            100000000000000000001
            100002000000000200001
            100000000020000000001
            100000100000000100001
            10000000020W002000001
            100000000000000000001
            100020000000000200001
            100000000000000000001
            111111111111111111111